place of work : 2011 census merged local authority district,S12000005,S12000006,S12000008,S12000010,S12000011,S12000013,S12000014,S12000015,S12000017,S12000018,S12000019,S12000020,S12000021,S12000023,S12000024,S12000026,S12000027,S12000028,S12000029,S12000030,S12000033,S12000034,S12000035,S12000036,S12000038,S12000039,S12000040,S12000041,S12000042,S12000044,S12000045,S12000046
E41000001,0,0,0,0,0,0,0,0,0,0,0,1,1,0,2,0,0,0,0,0,2,0,6,0,1,0,0,3,0,0,0,0
E41000002,0,0,0,0,0,0,0,1,0,0,0,1,2,0,1,1,0,0,0,0,4,1,3,1,0,1,0,2,0,1,0,3
E41000003,0,0,1,0,0,0,0,0,0,0,0,1,1,0,0,0,0,1,0,0,3,0,17,1,0,0,0,3,0,3,0,1
E41000004,1,0,0,0,0,0,3,0,0,0,0,5,1,0,0,0,0,0,0,1,10,2,4,3,0,0,0,1,0,0,0,4
E41000005,0,0,0,0,0,0,0,3,0,0,1,2,0,0,0,0,0,0,0,0,5,0,3,5,1,0,0,3,0,0,0,2
E41000047,0,0,0,1,0,0,1,1,0,0,1,6,10,0,2,1,0,0,3,4,1,4,11,13,1,0,1,10,1,4,0,4
E41000048,0,1,2,10,0,1,0,3,0,1,0,4,4,0,1,99,1,0,1,0,1,4,10,12,0,0,0,1,0,3,0,4
E41000276,0,0,1,0,0,0,0,6,0,0,0,0,1,0,2,0,0,0,1,0,0,0,0,4,1,0,0,3,1,0,0,1
E41000277,0,0,0,1,0,1,1,2,2,0,0,2,1,0,5,2,0,1,1,2,2,3,2,20,2,0,2,8,0,6,0,8
E41000278,0,3,0,3,0,0,0,3,1,0,0,0,1,0,0,4,3,0,1,1,2,0,5,2,0,0,0,1,0,0,0,4
E41000279,0,1,0,0,0,0,0,4,0,0,1,1,3,0,0,0,0,0,0,2,6,0,2,2,0,0,2,0,0,5,0,8
E41000280,0,0,0,0,0,0,0,3,2,0,1,1,14,0,2,0,1,0,2,23,7,2,8,6,0,0,0,2,0,1,0,2
E41000006,0,0,1,0,0,0,0,0,0,0,0,6,0,0,0,0,0,0,1,0,0,0,2,0,0,0,0,3,0,0,0,0
E41000007,0,2,2,0,0,0,1,1,0,0,0,2,0,0,1,1,2,0,2,1,0,0,1,0,0,0,1,2,0,1,0,0
E41000008,0,0,0,0,0,0,0,1,0,0,0,0,1,0,0,1,0,0,1,0,6,0,0,1,1,0,12,0,0,0,0,0
E41000009,0,1,0,0,0,0,0,2,0,0,0,0,0,0,0,0,0,0,0,0,1,0,0,0,0,0,0,0,0,1,0,1
E41000049,0,0,0,0,0,0,0,1,1,0,0,1,2,0,3,4,0,0,1,0,0,3,1,1,3,0,0,1,0,4,0,4
E41000050,0,0,0,0,0,0,2,1,0,0,0,3,3,0,0,0,0,0,1,0,4,0,4,4,0,0,0,1,0,1,0,0
E41000065,1,1,2,1,0,0,0,1,0,0,0,0,1,0,0,0,0,0,1,0,0,0,2,0,0,0,0,2,0,0,0,2
E41000066,0,1,0,0,0,0,0,0,0,0,0,0,0,0,0,0,0,0,0,0,0,0,3,0,0,0,0,0,0,0,0,1
E41000067,3,98,4,0,1,1,2,7,0,0,0,2,2,0,1,6,0,0,1,1,0,1,1,2,0,1,0,2,0,1,0,6
E41000068,0,3,0,0,0,0,0,1,1,0,2,0,2,0,0,0,0,0,0,0,0,0,4,0,0,1,0,1,0,0,0,0
E41000069,0,9,0,0,0,0,0,1,1,0,0,0,0,0,0,0,0,0,1,1,0,0,1,1,0,0,0,0,0,0,0,0
E41000070,0,0,1,0,0,0,1,0,0,0,0,2,0,0,0,0,0,0,0,0,0,1,1,3,1,0,0,0,0,0,0,1
E41000149,0,0,0,0,0,0,0,0,0,0,0,0,0,0,2,0,0,0,1,0,0,3,2,1,0,0,3,0,1,0,0,0
E41000150,0,1,0,0,0,0,0,0,0,0,0,0,0,0,0,0,0,0,0,0,0,0,0,1,0,0,1,0,0,0,0,3
E41000151,0,2,0,0,0,0,0,0,0,0,0,0,0,0,1,0,0,0,0,0,0,0,0,1,0,0,0,0,0,0,0,0
E41000152,0,0,0,0,0,0,0,1,0,0,0,1,1,0,0,0,0,0,0,0,5,0,5,0,0,0,6,1,1,0,0,1
E41000153,0,1,0,0,0,0,1,0,0,0,0,3,3,0,0,0,0,0,1,1,0,0,7,1,1,0,0,1,0,5,0,3
E41000154,0,0,0,0,0,0,0,0,3,0,0,0,1,0,0,0,0,0,1,0,0,1,2,1,0,0,0,5,0,0,0,0
E41000155,0,0,0,0,0,0,0,0,1,0,0,2,0,0,0,0,0,0,4,0,1,0,0,2,0,0,0,0,0,0,0,1
E41000156,0,0,0,0,0,0,0,0,0,0,0,0,2,0,0,0,0,0,0,0,0,0,0,0,0,0,1,0,0,0,0,0
E41000157,0,0,0,0,0,0,0,0,0,0,0,0,1,0,0,0,0,0,0,0,0,3,3,0,0,0,0,1,0,0,0,1
E41000158,0,0,0,0,0,0,1,1,0,0,0,2,1,0,1,0,0,0,0,0,0,1,2,0,0,0,0,4,0,0,0,1
E41000159,0,0,0,0,0,0,2,0,0,0,0,0,2,0,0,0,0,0,1,0,1,0,4,1,0,0,0,1,0,0,0,2
E41000160,0,1,0,0,0,0,1,0,0,0,0,0,0,0,0,0,1,0,1,0,0,1,1,0,0,0,0,0,0,0,0,1
E41000257,0,0,0,0,0,0,0,2,0,0,0,1,0,0,1,0,1,0,0,0,0,0,5,1,0,0,0,3,0,1,0,7
E41000258,0,0,0,0,0,0,0,0,0,0,0,6,0,0,0,0,0,0,1,1,0,0,1,4,0,0,0,3,0,1,0,3
E41000259,0,0,0,0,0,0,0,0,2,0,0,0,2,0,1,0,0,0,3,1,0,0,7,7,1,0,0,5,2,4,0,8
E41000260,0,1,0,0,0,0,0,0,0,0,0,1,0,0,1,0,0,1,1,0,0,0,5,1,0,0,0,4,1,1,0,0
E41000261,0,0,0,0,0,0,0,1,0,0,0,2,1,0,0,1,0,0,0,0,1,0,6,3,4,0,0,3,0,1,0,1
E41000262,0,0,0,0,0,0,0,0,1,0,0,1,1,0,0,1,0,0,0,0,0,0,9,1,0,0,0,0,0,1,0,4
E41000263,0,0,0,0,0,0,0,1,0,0,0,3,3,0,1,0,0,0,2,0,2,2,3,1,0,0,0,2,0,0,0,1
E41000264,0,0,1,2,0,0,0,0,0,0,0,0,4,0,0,3,0,1,2,0,0,1,1,0,0,0,0,1,0,0,0,1
E41000265,0,0,1,0,0,0,1,0,0,0,0,4,0,0,0,0,0,0,1,0,1,0,2,1,0,0,0,2,0,0,0,1
E41000266,0,1,0,0,0,0,0,2,0,0,0,1,1,0,0,0,0,0,0,1,1,0,0,1,2,0,0,5,0,0,0,3
E41000267,0,0,0,0,0,0,0,1,1,0,0,1,4,0,0,0,0,3,1,0,3,1,0,1,0,0,0,0,0,1,0,3
E41000268,0,0,0,0,0,0,0,1,1,0,1,0,2,0,1,0,0,0,5,1,4,0,2,3,2,0,2,1,0,0,0,10
E41000269,0,0,0,0,0,0,0,0,0,0,0,0,0,0,0,0,0,0,0,0,3,0,4,1,0,0,0,1,0,0,0,0
E41000270,0,0,0,0,0,0,0,1,4,0,0,1,6,0,2,0,0,1,3,0,3,0,5,1,1,0,1,1,0,2,0,2
E41000271,0,1,0,0,0,0,1,2,6,0,0,4,2,0,0,0,0,1,0,0,2,1,5,5,1,0,2,3,0,2,1,5
E41000010,0,0,0,0,0,0,0,1,0,0,0,2,0,0,0,0,0,0,0,0,1,5,4,0,0,0,0,0,0,0,0,3
E41000011,0,0,0,0,0,0,0,0,4,0,0,3,0,1,0,0,0,1,0,2,2,0,4,0,0,0,1,4,0,0,0,2
E41000012,0,0,0,1,0,0,0,2,0,0,0,3,0,0,0,0,0,1,0,0,2,0,4,0,0,0,0,0,0,2,0,2
E41000013,0,0,0,0,0,0,1,0,0,0,0,0,2,0,0,0,0,1,1,0,1,0,0,1,0,0,0,0,0,17,0,1
E41000014,0,0,0,3,0,0,0,1,2,0,0,1,0,0,0,2,0,0,0,2,0,0,2,3,0,0,0,4,0,0,0,0
E41000189,0,0,0,0,0,0,0,0,19,0,0,0,0,0,0,0,0,0,0,0,0,2,1,0,0,0,0,0,0,0,0,0
E41000190,0,1,0,1,0,0,0,2,0,0,0,0,0,0,0,0,0,0,0,0,1,2,0,1,0,0,0,0,0,0,0,4
E41000191,0,1,0,0,0,0,0,1,1,0,0,0,0,0,0,0,0,0,0,0,1,0,0,1,0,0,0,1,0,0,1,4
E41000192,0,0,0,0,0,0,0,0,2,1,0,0,0,0,0,0,0,0,0,0,0,0,1,2,0,0,0,0,0,0,0,1
E41000193,0,1,0,0,0,0,0,1,0,0,0,0,0,0,0,0,0,0,0,0,0,0,0,0,0,0,0,0,0,1,0,0
E41000194,0,0,0,0,0,0,0,2,0,0,6,2,1,0,0,0,0,1,0,2,0,3,3,1,1,0,0,1,0,0,0,0
E41000195,0,2,0,0,0,0,2,3,0,0,0,1,1,0,0,0,0,0,0,0,0,0,0,0,0,0,0,1,0,0,0,0
E41000272,0,0,0,0,0,0,1,0,0,0,0,3,2,0,2,0,0,0,0,0,1,0,1,3,2,3,0,1,0,3,0,0
E41000273,0,0,6,0,0,0,3,0,1,0,0,2,1,0,0,0,0,0,0,0,0,0,4,4,1,0,0,1,0,1,0,2
E41000274,0,0,2,0,0,0,0,0,0,0,0,1,1,0,0,0,0,0,2,0,2,2,7,1,1,0,3,0,0,6,0,4
E41000275,0,1,2,0,0,0,0,2,0,0,0,2,1,0,1,0,0,1,68,2,1,0,4,5,1,0,0,1,1,3,0,0
E41000288,0,0,0,0,0,0,0,4,8,0,0,0,0,0,4,0,0,0,1,0,1,0,3,5,0,0,1,1,1,0,0,2
E41000289,0,0,0,0,0,0,0,0,0,0,0,0,1,0,0,0,0,0,1,0,0,0,5,1,2,1,0,4,0,1,0,3
E41000290,0,0,0,0,0,0,0,1,0,0,0,1,0,0,4,1,0,0,1,0,2,1,1,2,0,0,1,5,0,2,0,0
E41000291,0,0,0,0,0,0,0,0,2,0,0,1,3,0,3,1,0,0,7,0,5,3,5,14,2,0,1,4,0,1,0,5
E41000292,0,0,1,0,0,0,2,0,2,0,0,2,4,0,2,0,0,0,1,0,0,0,8,4,2,0,0,2,0,1,0,1
E41000015,0,2,0,0,2,0,0,1,2,0,0,0,2,0,0,0,0,0,1,0,1,0,2,7,0,0,0,2,0,0,0,1
E41000016,0,0,0,0,0,0,0,0,0,0,0,0,0,0,0,0,0,0,4,1,1,1,2,3,0,0,0,1,1,0,0,2
E41000017,0,0,0,0,0,0,0,1,0,0,0,1,0,0,0,0,0,0,0,0,0,0,0,0,0,0,0,0,0,0,0,0
E41000018,0,0,0,0,0,0,0,0,0,0,0,1,2,0,0,0,0,0,3,0,2,1,1,4,1,0,0,1,0,4,0,6
E41000071,0,0,0,0,0,0,0,0,1,0,0,3,0,0,3,0,0,0,0,0,0,0,1,1,1,0,0,0,0,0,0,1
E41000072,0,0,0,0,0,0,0,0,0,0,0,1,0,0,0,0,0,0,0,0,0,0,0,0,1,0,0,0,0,0,0,0
E41000073,0,0,0,0,0,0,0,0,0,0,0,0,0,0,0,0,0,0,1,0,0,0,0,1,1,0,0,0,0,0,0,0
E41000074,0,0,0,0,0,0,0,0,0,0,0,2,0,0,0,0,0,2,0,0,0,0,0,0,0,0,0,0,0,0,0,0
E41000075,0,0,0,0,0,0,0,0,0,0,0,0,0,0,0,0,0,1,1,0,0,1,1,1,0,0,0,0,0,0,0,0
E41000076,0,0,0,0,0,0,0,0,0,0,0,1,1,0,0,0,0,0,0,0,0,1,1,1,0,0,0,0,0,0,0,0
E41000077,0,0,1,0,0,0,0,0,0,0,0,0,0,0,1,0,0,0,3,0,0,0,0,0,0,0,3,0,0,1,0,0
E41000078,0,0,0,0,0,0,0,0,0,0,0,0,0,0,0,1,0,0,0,0,0,1,0,0,0,0,0,3,0,0,0,2
E41000161,0,0,0,1,0,0,0,0,0,0,0,0,0,0,0,0,0,0,3,0,0,0,0,1,0,1,0,0,0,0,0,0
E41000162,0,2,0,0,0,0,2,0,0,0,0,0,0,0,0,0,0,1,1,0,1,2,0,0,0,0,2,0,0,0,0,0
E41000163,0,1,0,0,0,0,0,0,0,0,0,0,0,0,0,0,0,0,0,0,0,0,0,2,0,0,0,0,0,0,0,0
E41000164,0,0,0,0,0,0,0,0,0,0,0,0,0,0,3,1,0,0,0,0,0,0,0,0,0,0,0,0,0,0,0,0
E41000165,0,0,0,0,0,0,0,0,0,0,0,0,1,0,0,0,0,0,0,0,0,0,0,0,0,0,0,0,0,0,0,0
E41000166,0,0,0,0,0,0,0,0,0,0,0,0,1,0,0,0,1,1,1,0,0,0,0,1,0,0,0,5,0,0,0,0
E41000167,0,0,0,0,0,0,0,0,0,0,0,0,0,0,0,0,0,0,0,0,0,0,0,0,0,0,1,0,0,0,0,0
E41000168,0,0,0,0,0,0,0,0,0,0,0,0,0,0,0,0,0,0,0,0,0,1,1,1,0,0,0,1,0,0,0,0
E41000169,0,0,0,0,0,0,0,1,0,0,0,3,0,0,0,0,0,0,0,0,0,0,2,1,0,0,0,0,0,2,0,0
E41000170,0,0,0,0,0,0,0,0,0,0,0,1,0,0,0,0,0,0,0,0,0,0,4,0,0,0,0,0,0,0,0,0
E41000171,0,0,0,0,0,0,0,1,0,0,0,3,0,0,0,0,0,0,0,0,1,0,1,0,0,0,0,0,0,0,0,0
E41000172,0,0,0,0,0,0,0,0,0,0,0,1,0,0,0,0,0,0,0,0,0,1,0,0,0,0,0,1,0,0,0,0
E41000173,0,0,0,0,0,0,0,2,0,0,0,0,1,0,0,0,0,0,0,0,2,0,2,0,0,0,0,0,0,0,0,0
E41000174,0,0,0,0,0,0,0,4,1,0,0,1,0,0,0,0,0,0,0,1,0,0,0,0,0,0,0,2,0,0,0,0
E41000182,0,0,0,0,0,0,0,0,0,0,0,0,9,0,0,0,0,0,1,0,0,0,0,0,0,0,0,0,0,8,0,0
E41000183,0,0,0,0,0,0,0,0,0,0,0,0,0,0,0,0,0,0,0,0,0,0,1,0,0,0,0,0,0,0,0,0
E41000184,0,0,0,0,0,0,0,0,0,0,0,0,1,0,0,0,0,0,0,0,0,0,0,0,0,0,0,0,0,0,0,0
E41000185,0,1,0,0,0,0,0,0,0,0,0,0,2,0,1,0,0,0,0,0,0,0,0,1,0,0,0,0,0,0,0,0
E41000186,0,0,0,0,0,0,0,0,2,0,0,0,0,0,0,0,0,0,3,0,0,0,2,1,0,0,1,1,0,0,0,0
E41000187,0,0,0,0,0,0,0,0,0,0,0,0,1,0,0,0,0,0,1,0,0,0,0,0,0,0,3,0,0,0,0,0
E41000188,0,0,0,0,0,0,0,0,0,0,0,3,0,0,0,0,0,0,0,1,0,0,0,0,0,0,2,0,0,0,0,1
E41000196,0,0,0,0,0,0,0,0,0,0,0,0,1,0,1,0,0,0,1,2,0,0,2,6,0,0,1,0,0,1,0,0
E41000197,0,0,0,0,0,0,0,0,0,0,0,0,0,0,0,0,0,1,1,0,0,1,3,1,0,0,0,1,0,0,1,1
E41000198,0,0,0,0,0,0,0,0,0,0,0,1,1,0,0,0,0,0,1,0,0,0,0,1,1,0,0,0,0,0,0,2
E41000199,0,0,0,0,0,0,0,2,0,0,0,0,2,0,1,0,0,0,0,0,0,0,0,2,0,0,0,1,1,3,0,0
E41000200,0,0,0,0,0,0,0,0,0,0,0,0,0,0,0,0,0,0,0,0,0,1,3,3,0,0,0,0,0,1,0,0
E41000201,0,0,0,0,0,0,0,0,0,0,0,0,1,0,0,0,0,0,0,0,0,2,1,1,0,0,0,2,0,1,0,0
E41000202,0,0,1,0,0,0,0,0,0,0,0,1,0,0,0,0,4,1,0,0,0,0,0,1,0,0,0,2,0,1,0,3
E41000019,0,0,0,0,0,0,0,1,0,0,0,0,0,0,14,0,0,0,0,0,0,0,0,0,0,0,1,6,0,0,0,0
E41000020,0,0,0,0,0,0,0,2,0,0,1,1,0,0,0,0,0,0,1,0,0,0,1,0,0,0,0,0,0,0,0,0
E41000021,0,0,1,0,0,0,0,1,1,0,1,1,1,0,0,0,0,1,0,0,0,3,2,0,0,0,0,2,0,1,0,2
E41000051,0,1,0,0,0,0,0,1,3,0,0,0,1,0,0,0,0,0,0,0,1,1,5,7,0,0,0,1,0,0,0,1
E41000213,0,0,0,0,0,0,1,0,0,0,0,0,0,0,0,0,0,0,3,0,2,0,0,0,0,0,0,1,0,0,0,1
E41000214,0,0,0,0,0,0,0,0,1,0,0,0,0,0,0,0,0,0,1,0,0,1,0,2,0,0,0,1,0,0,0,0
E41000215,0,0,0,0,0,0,0,0,0,0,1,0,1,0,0,0,0,1,1,0,1,0,1,1,0,0,0,0,0,0,0,0
E41000216,0,0,0,0,0,0,0,0,2,0,0,3,0,0,0,0,0,1,0,0,1,3,0,0,0,0,0,0,0,0,0,0
E41000217,0,0,0,0,0,0,0,1,1,0,3,0,0,0,1,0,0,0,1,0,0,4,1,1,0,0,0,2,0,1,0,0
E41000218,0,0,1,0,0,0,0,1,0,0,0,0,1,0,0,0,0,1,1,0,0,1,0,1,0,0,0,3,0,0,0,0
E41000219,0,0,0,0,0,0,0,0,1,0,0,0,0,0,0,0,0,0,1,0,0,1,0,1,0,0,0,1,0,0,0,0
E41000220,0,0,0,0,0,0,0,0,0,0,0,0,1,0,0,0,0,0,0,0,0,0,1,0,1,0,0,0,0,0,0,0
E41000239,0,0,0,0,0,0,0,0,0,0,0,0,0,0,0,0,0,0,0,0,0,0,0,0,0,0,0,0,0,0,0,0
E41000240,0,0,0,0,0,0,0,1,0,0,0,0,0,0,0,0,0,0,0,0,0,0,0,1,0,0,0,2,0,0,0,0
E41000241,0,0,0,0,0,0,0,0,0,0,0,0,0,0,0,0,0,0,0,0,0,0,1,1,0,0,0,0,0,0,0,0
E41000242,0,0,0,0,0,0,0,0,0,0,0,0,0,0,0,0,1,0,0,0,0,1,0,1,0,0,0,1,0,0,0,0
E41000243,0,0,0,0,0,0,3,0,0,0,0,0,0,0,0,0,0,0,0,0,0,0,3,1,0,0,0,1,0,0,0,0
E41000251,0,0,0,0,0,0,0,0,2,0,1,2,1,0,0,0,0,0,0,0,0,0,0,0,0,0,0,0,0,0,0,1
E41000252,0,0,0,0,0,0,0,1,0,0,0,0,0,0,0,0,0,0,0,0,0,0,0,0,0,0,0,1,0,0,0,0
E41000253,0,0,0,0,0,0,0,0,1,0,0,0,0,0,0,0,0,0,2,0,1,0,0,0,2,0,0,0,0,0,0,1
E41000254,0,0,0,0,0,0,0,5,1,0,0,0,1,0,0,0,0,0,6,0,0,2,0,0,0,0,0,0,0,0,0,2
E41000255,0,0,0,0,0,0,0,0,0,0,1,2,0,0,0,0,0,0,1,0,0,0,1,0,0,0,0,0,0,0,0,1
E41000256,0,0,0,0,0,0,0,0,0,0,0,1,0,0,0,0,0,0,0,0,1,0,3,0,3,0,0,1,0,1,0,0
E41000281,0,1,0,0,0,1,1,1,0,0,0,0,0,0,0,0,0,0,16,1,4,2,2,7,2,0,0,5,0,3,1,6
E41000282,0,0,0,0,0,0,0,1,0,0,0,1,0,0,0,0,0,0,1,0,3,0,5,2,1,0,0,1,0,0,0,1
E41000283,0,1,0,0,0,0,1,0,2,0,24,1,1,0,0,0,0,0,1,0,0,0,0,1,1,0,0,0,0,2,0,2
E41000284,0,0,0,0,0,0,5,2,0,0,10,0,0,0,1,0,0,0,4,0,0,2,0,1,0,0,0,2,0,2,0,2
E41000285,0,0,0,0,0,0,0,0,1,0,2,0,0,0,0,0,0,0,4,3,0,1,3,0,0,0,0,4,0,1,0,2
E41000286,0,0,0,0,0,0,0,4,0,0,19,0,1,0,0,1,0,1,2,0,2,0,1,1,0,0,0,0,0,1,0,3
E41000287,0,0,0,0,0,0,0,2,0,0,51,1,1,0,1,0,0,1,1,0,0,0,1,1,0,0,0,1,0,1,0,0
E41000031,0,0,0,0,0,0,0,0,0,0,4,1,1,0,0,0,0,1,1,0,0,0,3,2,0,0,0,0,0,0,0,1
E41000032,0,0,0,0,0,0,0,0,0,0,0,0,0,0,0,0,0,0,3,0,0,0,1,3,0,0,0,1,0,1,0,0
E41000033,0,0,0,0,0,0,0,0,0,0,0,0,0,0,0,0,0,0,0,0,0,0,0,0,0,0,0,0,0,1,0,0
E41000034,0,0,0,0,0,0,0,0,0,0,0,0,1,0,0,0,0,0,0,0,0,0,0,0,0,0,0,0,0,0,0,0
E41000054,0,0,0,0,0,0,1,0,0,0,0,0,0,0,0,0,0,0,0,0,0,1,0,0,0,0,0,4,0,0,0,0
E41000055,0,0,0,0,0,0,0,0,0,0,0,1,1,0,1,0,0,0,0,0,0,0,0,0,0,0,0,2,0,1,0,2
E41000060,0,0,0,0,0,0,0,1,0,0,0,0,0,0,1,0,0,0,0,0,1,0,0,1,0,0,0,0,0,0,0,1
E41000061,0,2,0,0,0,0,0,1,0,0,0,0,0,0,0,0,0,0,0,0,0,0,0,0,0,0,0,0,0,0,0,0
E41000062,0,1,0,0,0,0,0,6,0,0,0,0,0,0,0,0,0,0,1,0,0,1,0,4,0,0,0,0,0,0,0,0
E41000063,0,0,0,0,0,0,1,0,0,0,0,0,1,0,0,0,0,2,2,0,1,0,1,1,0,0,0,0,0,1,0,1
E41000064,0,0,0,0,0,0,0,0,0,0,0,0,0,0,0,0,0,0,1,0,1,0,0,0,0,0,2,1,0,1,0,0
E41000098,0,0,0,0,0,0,0,0,0,0,0,0,1,0,1,0,0,0,2,0,0,0,1,0,0,0,0,1,0,2,0,0
E41000099,0,0,0,0,0,0,0,0,1,0,0,0,1,0,0,0,0,0,0,0,0,0,0,2,0,0,0,1,0,0,0,0
E41000100,0,0,0,0,0,0,0,0,0,0,0,0,0,0,0,0,0,0,0,0,0,0,0,1,0,0,1,0,0,1,0,2
E41000101,0,0,0,0,0,0,0,0,0,0,0,0,0,0,0,0,0,0,0,0,0,0,0,0,0,0,0,1,0,0,0,0
E41000102,0,0,0,0,0,0,0,0,0,0,0,0,1,0,1,0,0,0,0,0,0,0,1,1,1,0,0,3,0,0,0,0
E41000103,0,0,0,0,0,0,0,2,0,0,0,1,0,0,0,0,0,0,0,0,0,0,0,0,0,0,0,0,0,0,0,0
E41000104,0,0,0,0,0,0,0,0,0,0,0,0,0,0,0,0,0,4,0,0,0,0,0,0,0,0,1,0,0,0,0,1
E41000105,0,0,0,0,0,0,0,0,0,0,0,0,0,0,0,0,0,1,0,0,1,0,0,1,0,0,0,0,0,0,0,0
E41000106,0,0,0,0,0,0,0,0,0,0,0,0,0,0,0,0,0,0,0,0,0,0,0,0,0,0,0,0,0,1,0,0
E41000107,0,0,0,0,0,0,0,0,0,0,0,0,0,0,0,0,0,0,1,0,0,0,0,0,0,0,0,0,0,1,0,0
E41000108,0,0,0,0,0,0,0,0,2,0,0,0,1,0,0,0,0,0,0,0,0,1,0,0,0,0,0,0,0,0,0,0
E41000109,0,0,0,0,0,0,0,0,0,0,0,1,0,0,1,0,0,0,0,0,0,0,0,0,0,0,0,0,0,0,0,0
E41000127,0,0,1,0,0,0,0,0,0,0,0,0,0,0,0,0,0,0,0,0,0,0,0,2,1,0,0,0,0,0,0,0
E41000128,0,0,0,0,0,0,0,0,0,0,0,1,0,0,0,0,0,0,0,0,0,0,0,2,0,0,0,0,0,1,0,0
E41000129,0,0,0,0,0,0,0,0,0,0,0,0,0,0,1,0,0,0,0,0,0,0,0,3,0,0,0,0,0,0,0,0
E41000130,0,0,0,0,0,0,0,0,0,0,0,0,0,0,0,0,0,0,0,3,1,0,0,0,0,0,0,0,0,0,0,0
E41000131,0,0,0,0,0,0,0,0,1,0,0,0,0,0,1,0,0,0,0,0,0,0,1,0,0,0,0,0,0,0,0,0
E41000132,0,0,0,0,0,0,0,0,0,0,0,0,0,0,0,0,0,0,0,0,0,0,0,1,0,0,0,1,0,0,0,0
E41000133,0,0,0,0,0,0,0,0,0,0,0,0,0,0,0,0,0,0,0,0,0,0,0,0,0,0,0,0,0,1,0,0
E41000134,0,0,0,0,0,0,0,0,0,0,0,0,0,0,0,0,0,0,0,0,0,0,0,0,0,0,0,0,0,0,0,0
E41000135,0,0,0,0,0,0,0,0,0,0,0,0,0,0,0,0,0,0,0,0,0,0,0,0,0,0,0,0,0,0,0,0
E41000136,0,0,0,0,0,0,0,0,0,0,0,0,0,0,0,0,0,0,0,0,0,1,0,0,0,0,0,0,0,0,0,0
E41000175,0,0,0,0,0,0,0,0,0,0,0,1,0,0,0,0,0,0,0,0,0,0,2,0,0,0,1,1,0,0,0,0
E41000176,0,0,0,0,0,0,0,0,0,0,0,0,1,0,0,0,0,0,0,0,0,0,1,0,0,0,0,0,0,0,0,0
E41000177,0,0,0,0,0,0,0,0,0,0,0,1,2,0,0,0,0,0,0,0,1,4,0,0,0,0,0,1,0,0,0,0
E41000178,0,0,0,0,0,0,0,0,0,0,0,2,2,0,0,0,0,0,0,0,1,1,0,0,0,0,0,0,0,0,0,0
E41000179,0,0,0,0,0,0,0,0,0,0,0,2,0,0,0,0,0,0,0,0,2,1,4,0,0,0,0,2,0,1,0,0
E41000180,0,0,0,0,0,1,0,0,0,0,0,1,1,0,2,0,0,0,0,0,0,0,0,1,0,0,0,0,0,1,0,0
E41000181,0,0,0,1,0,0,0,1,0,0,0,0,0,1,0,0,0,0,0,0,0,0,0,0,0,0,0,0,0,0,0,1
E41000221,0,0,0,0,0,0,0,0,0,0,0,0,0,0,1,0,0,0,0,0,0,0,2,1,0,0,0,0,0,0,0,0
E41000222,0,0,0,0,0,0,0,0,0,0,0,0,0,0,0,0,0,0,0,0,1,0,0,0,0,0,0,0,0,0,0,0
E41000223,0,0,0,0,0,0,0,0,0,0,0,1,0,0,0,0,0,0,0,0,0,0,1,0,0,0,0,1,0,0,0,1
E41000224,0,0,0,0,0,0,0,0,1,0,0,0,0,0,0,0,0,0,0,0,1,0,1,0,0,0,0,0,0,0,0,1
E41000225,0,0,0,0,0,0,0,1,0,0,0,1,0,0,0,0,0,0,0,0,0,0,0,0,0,0,0,0,0,0,0,1
E41000226,0,0,0,0,0,0,0,0,0,0,0,0,0,0,1,0,0,0,4,0,0,0,1,0,1,0,0,0,0,0,0,2
E41000227,0,0,0,0,0,0,0,0,0,0,0,1,0,0,0,0,0,0,0,0,2,1,1,0,1,0,1,0,0,0,0,0
E41000293,0,0,0,0,0,0,0,0,0,0,0,0,0,0,1,0,0,0,3,0,0,0,0,2,0,0,0,0,0,0,0,2
E41000294,0,0,0,0,0,0,0,0,0,0,0,0,0,0,0,0,0,0,0,0,0,0,0,0,0,0,0,0,0,0,0,0
E41000295,0,1,0,0,0,0,0,0,0,0,0,0,0,0,0,0,0,0,2,0,0,2,1,1,0,0,0,1,0,2,0,1
E41000296,0,0,0,0,0,0,0,0,0,0,0,1,0,0,0,0,0,0,0,0,1,0,0,4,0,0,0,1,0,0,0,0
E41000297,0,1,0,0,0,0,0,1,0,0,0,0,0,0,0,0,0,0,1,3,2,0,2,1,0,0,1,0,0,0,0,1
E41000298,0,0,0,1,0,0,0,1,0,0,0,0,0,0,0,0,0,0,0,0,0,0,1,2,0,0,0,0,0,0,0,0
E41000299,0,0,0,0,0,0,0,0,0,0,0,0,1,0,1,0,0,1,2,0,0,0,0,2,1,0,0,2,0,1,0,1
E41000300,0,0,0,0,0,0,0,0,1,0,0,0,1,0,0,0,0,0,1,0,1,0,0,1,0,0,0,3,0,1,0,3
E41000301,0,0,0,0,0,0,0,0,0,0,0,0,0,0,0,0,0,0,0,0,1,0,0,0,0,0,0,1,0,0,0,0
E41000302,0,0,0,0,0,0,0,0,0,0,0,0,0,0,0,0,0,0,2,0,1,0,0,1,3,0,1,1,0,0,0,0
E41000303,0,0,0,0,0,0,0,0,1,0,0,0,0,0,0,0,0,0,0,0,0,0,0,0,0,0,0,0,0,1,0,0
E41000304,0,0,0,0,0,1,0,0,0,0,0,1,0,0,0,0,0,0,1,0,0,0,1,0,0,0,2,0,0,1,0,0
E41000305,0,0,0,0,0,0,0,0,0,0,0,0,0,0,0,0,0,0,0,0,1,0,0,3,0,0,0,0,0,0,0,2
E41000306,0,2,0,0,0,0,0,2,0,0,0,0,0,0,0,0,0,0,0,0,0,0,0,2,0,0,0,0,0,0,0,4
E41000307,0,0,0,0,0,0,0,0,0,0,0,0,0,0,0,0,0,0,1,0,0,0,0,0,0,0,0,0,0,1,0,0
E41000308,0,0,0,0,0,0,1,1,0,0,0,0,1,0,0,0,0,0,0,0,0,0,0,0,0,0,1,1,0,0,0,3
E41000309,0,0,0,0,0,1,0,1,0,0,0,0,0,0,0,0,0,0,0,0,1,0,0,1,0,0,0,0,0,0,0,1
E41000310,0,0,0,0,0,0,0,0,0,0,0,0,0,0,0,0,0,0,1,0,0,0,0,1,0,0,0,0,0,0,0,3
E41000311,0,0,0,0,0,0,0,0,2,0,0,0,0,0,0,0,0,0,0,0,3,0,0,2,0,0,0,1,1,0,0,0
E41000312,0,0,0,0,0,0,0,3,0,0,0,0,0,0,0,0,0,0,0,0,1,0,0,0,0,0,0,0,0,0,0,1
E41000313,0,0,0,0,0,0,0,0,0,0,0,0,0,0,0,1,0,0,1,0,0,0,1,2,0,1,0,0,0,0,1,0
E41000314,0,0,0,0,0,0,0,2,0,0,0,0,0,0,0,0,0,0,0,0,1,0,0,0,0,0,0,0,0,0,0,0
E41000315,0,0,0,0,0,0,0,0,0,0,0,0,1,0,0,0,0,0,0,0,0,0,0,3,0,0,0,0,0,1,0,1
E41000316,0,0,0,0,0,0,0,0,2,0,0,0,0,0,0,0,0,0,2,0,0,0,0,1,0,0,0,0,0,1,0,3
E41000317,0,0,0,0,0,0,0,0,1,0,0,0,0,0,1,0,0,0,0,1,0,0,0,1,0,0,1,0,0,0,0,2
E41000318,0,0,0,0,0,0,0,0,0,0,0,0,0,0,0,0,0,0,0,0,0,0,0,0,0,0,2,0,0,0,0,0
E41000319,0,0,0,0,0,1,0,0,0,0,0,0,0,0,0,0,0,0,1,0,0,0,0,1,0,0,1,0,0,0,0,2
E41000320,0,0,0,0,0,0,0,1,1,0,0,0,0,0,0,0,0,0,0,0,0,0,0,0,1,0,0,1,0,1,0,1
E41000321,0,0,0,0,0,0,0,1,0,0,0,0,0,0,1,0,0,0,2,0,0,3,0,3,0,0,0,1,0,0,0,2
E41000322,0,0,0,0,0,0,0,0,0,0,0,0,0,0,0,0,0,0,0,0,0,0,0,2,0,0,0,1,0,0,0,2
E41000323,0,0,0,0,0,0,0,1,0,0,0,0,0,0,0,0,0,0,2,0,1,0,0,1,0,0,0,0,0,0,0,0
E41000324,0,0,0,0,0,0,0,0,0,0,0,0,0,0,2,0,0,0,0,0,0,0,0,1,0,0,0,0,0,1,0,1
E41000035,0,0,0,0,0,0,0,0,0,0,0,1,0,0,0,0,0,1,1,0,2,0,0,0,0,0,1,2,0,0,0,0
E41000036,0,0,0,0,0,0,0,0,0,0,0,0,0,0,0,0,0,0,0,0,0,0,0,0,0,0,0,0,0,0,0,1
E41000037,0,0,0,0,0,0,0,0,0,0,0,0,0,0,0,0,0,0,0,0,0,0,0,0,0,0,0,0,0,0,0,1
E41000038,0,0,0,0,0,0,1,0,0,0,0,0,0,0,0,0,0,0,1,1,0,0,3,1,0,0,0,0,0,0,0,1
E41000039,0,0,0,0,0,0,0,0,0,0,0,0,0,0,0,0,0,0,0,0,0,0,0,0,0,0,0,0,0,0,0,0
E41000040,0,0,0,0,0,0,0,0,0,0,0,0,0,0,0,0,0,0,0,0,0,0,1,5,0,0,0,0,0,0,0,2
E41000041,0,0,0,0,0,0,0,0,0,0,0,0,0,0,0,0,0,0,0,0,0,0,1,1,0,0,0,0,0,1,0,0
E41000042,0,0,0,0,0,0,0,0,1,0,0,2,0,0,0,0,0,0,0,0,1,0,1,0,0,0,0,2,0,0,0,0
E41000043,0,0,0,0,0,0,0,1,1,0,0,0,0,0,0,0,0,0,1,0,0,0,0,1,1,0,0,0,0,2,0,0
E41000044,0,0,0,0,0,0,0,1,0,0,0,0,0,0,1,0,0,1,0,0,0,0,4,4,0,1,0,5,0,3,1,1
E41000045,0,1,0,0,0,0,0,2,0,0,0,0,0,0,0,0,0,0,0,1,0,0,4,0,0,0,1,1,0,0,0,0
E41000046,0,0,0,0,0,0,0,1,0,0,0,0,0,0,0,0,0,0,0,0,0,1,0,0,0,0,0,3,0,0,0,0
E41000056,0,0,0,0,0,0,0,0,1,0,0,0,0,0,0,0,0,4,0,0,0,0,0,1,0,0,1,1,0,0,0,0
E41000057,0,0,0,0,0,0,0,1,0,0,0,0,0,0,0,0,0,0,0,0,0,0,0,0,0,0,0,0,0,0,0,0
E41000058,0,0,0,0,0,0,0,1,0,0,0,0,0,0,0,0,0,1,0,0,0,1,0,0,0,0,0,0,0,0,0,0
E41000059,0,0,0,0,0,0,0,0,0,0,0,0,0,0,0,0,0,0,0,0,0,0,0,3,0,0,0,0,0,0,0,0
E41000093,0,0,0,0,0,0,0,1,0,0,0,1,0,0,0,1,0,0,0,0,0,0,1,0,0,0,0,0,0,0,0,0
E41000094,0,0,2,0,0,0,0,0,0,0,0,0,0,0,0,0,0,0,0,0,0,0,0,0,0,0,2,0,0,0,0,0
E41000095,0,1,0,0,0,0,0,0,0,0,0,3,0,0,0,0,0,0,0,0,0,0,0,0,0,0,0,0,0,0,0,0
E41000096,0,0,0,0,0,0,0,1,0,0,0,0,0,0,0,0,0,0,0,0,0,0,0,0,0,0,0,0,0,0,0,0
E41000097,0,0,0,0,0,0,0,0,0,0,0,1,0,0,2,1,0,1,0,0,0,0,1,0,0,0,0,1,0,0,0,0
E41000116,0,0,0,0,0,0,0,1,0,0,0,0,0,0,0,0,0,0,0,0,2,0,0,0,0,0,0,1,0,1,0,2
E41000117,0,0,0,0,0,0,0,0,0,0,0,0,2,0,0,0,0,0,0,0,0,0,0,1,0,0,0,0,0,0,0,0
E41000118,0,0,0,0,0,0,0,0,0,0,0,0,0,0,0,0,0,1,0,0,0,0,0,0,0,0,1,0,0,1,0,0
E41000119,0,0,0,0,0,0,0,1,0,0,0,0,0,0,1,0,0,0,0,0,0,0,4,0,0,0,0,0,0,0,0,2
E41000120,0,0,0,0,0,0,0,3,0,0,0,0,0,0,1,0,0,0,0,0,0,0,3,0,0,0,1,0,0,0,0,0
E41000121,0,0,0,0,0,0,0,0,0,0,0,0,0,0,0,0,0,0,0,0,0,0,0,0,0,0,0,2,0,0,0,1
E41000122,0,0,0,0,0,0,0,1,0,0,0,0,2,0,0,0,0,0,0,0,0,0,0,0,1,0,1,1,0,0,0,1
E41000123,0,1,0,0,0,0,0,1,1,0,0,0,1,0,0,0,0,0,0,0,0,0,1,0,0,0,0,0,0,0,0,0
E41000124,0,0,0,0,0,0,0,0,0,0,0,0,0,0,1,0,0,0,0,0,0,1,1,0,0,0,0,0,0,0,0,1
E41000125,0,1,0,0,0,0,0,0,1,0,0,0,0,0,0,0,0,0,0,0,0,0,0,1,0,0,0,0,0,0,0,0
E41000126,0,0,0,0,0,0,1,0,0,0,0,0,1,0,0,0,0,0,0,0,0,0,1,0,0,0,0,0,0,0,0,0
E41000137,0,0,0,0,0,0,0,0,0,0,0,0,0,0,0,0,0,0,0,0,1,0,0,0,0,0,0,1,0,0,0,3
E41000138,0,1,0,0,0,0,0,0,2,0,0,0,0,0,0,0,0,0,0,1,0,0,0,0,1,0,0,0,0,0,0,1
E41000139,0,0,0,0,0,0,0,0,0,0,0,0,0,0,0,0,0,0,1,0,0,0,0,0,0,0,0,0,0,1,0,0
E41000140,0,0,0,0,0,0,0,0,0,0,0,0,0,0,1,0,0,0,0,0,0,1,5,0,0,0,0,0,0,0,0,0
E41000141,0,0,0,0,0,0,1,0,1,0,0,0,0,0,0,0,0,0,0,0,0,0,0,3,1,0,0,0,0,0,0,0
E41000142,0,0,0,0,0,0,0,0,0,0,0,1,0,0,0,0,0,0,0,0,1,0,1,0,0,0,0,1,0,1,0,1
E41000143,0,0,0,0,0,0,0,0,0,0,0,0,0,0,0,0,0,0,0,0,0,0,0,0,0,0,0,1,0,0,0,0
E41000144,0,0,0,0,0,0,0,1,0,0,0,0,0,0,0,0,0,0,0,1,0,0,0,1,0,0,0,1,0,0,0,0
E41000145,0,0,0,0,0,0,0,0,0,0,0,2,3,0,0,0,0,0,1,0,0,0,1,1,0,0,0,1,0,0,0,0
E41000146,0,0,0,0,0,0,0,0,0,0,0,0,0,0,0,0,0,0,1,0,0,0,0,0,0,0,0,2,0,0,0,1
E41000147,0,0,0,0,0,0,0,0,0,0,0,0,0,0,0,0,0,0,1,0,0,0,0,0,0,0,0,1,0,1,0,1
E41000148,0,0,0,0,0,0,0,0,0,0,0,0,0,0,0,0,0,0,1,0,0,0,0,0,0,0,0,0,0,0,0,0
E41000203,0,0,0,0,0,0,0,0,0,0,0,1,0,0,0,0,0,0,0,0,0,0,0,0,0,0,0,1,0,0,0,0
E41000204,0,0,0,0,0,0,0,0,0,0,0,0,0,0,0,1,0,0,0,0,1,0,1,4,0,0,0,1,0,0,0,0
E41000205,0,0,0,1,0,0,0,0,0,0,0,0,0,0,2,0,0,0,0,0,0,0,0,0,1,0,0,0,0,2,0,1
E41000206,0,0,0,0,0,0,0,0,0,0,1,0,0,0,0,0,0,0,0,0,0,0,0,0,0,0,0,0,1,0,0,0
E41000207,0,0,1,0,0,0,0,0,1,0,0,0,0,0,3,0,0,0,0,0,0,0,0,0,0,0,0,1,0,0,0,0
E41000228,0,0,0,0,0,0,0,0,0,0,0,0,0,0,0,0,0,0,0,0,0,0,1,0,0,0,0,0,0,0,0,0
E41000229,0,0,0,0,0,0,0,0,0,0,0,0,1,0,3,0,0,0,0,1,0,0,0,0,0,0,1,2,0,0,0,0
E41000230,0,0,0,0,0,0,0,0,0,0,0,0,0,0,0,0,0,0,0,0,0,0,0,1,0,1,0,0,0,0,0,1
E41000231,0,0,0,0,0,0,0,0,0,0,0,2,0,0,0,0,0,0,0,2,0,0,0,0,0,0,0,1,0,0,0,0
E41000232,0,0,0,0,0,0,0,0,0,0,0,0,0,0,0,0,0,0,0,0,0,0,0,1,0,0,0,0,0,0,0,2
E41000233,0,0,0,0,0,0,0,1,0,0,0,0,0,0,0,0,0,0,0,0,0,0,0,1,0,1,0,0,0,0,0,0
E41000234,0,0,0,0,0,0,0,0,0,0,0,0,0,0,0,0,0,0,0,0,0,0,0,0,0,0,0,0,0,0,0,0
E41000235,0,0,0,0,0,0,0,0,0,0,0,0,0,0,0,0,0,0,0,0,0,0,0,0,0,0,0,1,0,0,0,0
E41000236,0,0,0,0,0,0,0,2,0,0,0,0,0,0,0,0,0,0,0,0,1,0,0,1,0,0,0,0,0,0,0,1
E41000237,0,0,0,0,0,0,0,0,0,0,0,0,0,0,0,0,0,0,0,0,0,0,0,0,0,0,0,0,0,0,0,1
E41000238,0,0,0,0,0,0,0,0,0,0,0,0,0,0,0,0,0,0,0,0,0,0,0,0,1,0,0,0,0,0,0,1
E41000244,0,0,0,0,0,0,0,0,0,0,0,0,0,0,0,0,0,0,1,0,0,0,0,1,0,0,0,0,0,0,0,0
E41000245,0,0,0,0,0,0,0,0,0,0,0,1,1,0,0,0,0,0,0,0,0,0,0,1,0,0,0,0,0,0,0,0
E41000246,0,0,0,0,0,0,0,0,0,0,0,0,0,0,0,0,0,0,0,0,0,0,0,0,0,0,0,0,0,0,0,1
E41000247,0,0,0,0,0,0,0,0,1,0,0,0,1,0,0,0,0,0,0,1,0,0,0,0,0,0,0,1,0,0,0,3
E41000248,0,0,0,0,0,0,0,0,1,0,0,0,0,0,1,0,0,0,0,0,1,0,0,2,0,0,0,0,0,0,0,0
E41000249,0,0,0,0,0,0,0,0,0,0,0,0,0,0,0,1,0,1,0,0,0,0,0,0,0,0,0,0,0,0,0,0
E41000250,0,0,0,0,0,0,0,0,0,0,0,0,0,0,0,0,0,0,1,0,0,0,1,0,0,0,0,0,0,0,0,0
E41000022,0,0,0,0,0,0,0,0,0,0,1,0,2,0,1,1,0,0,0,0,2,0,0,0,0,0,0,0,0,0,0,0
E41000023,0,0,0,0,0,0,0,2,1,0,0,0,0,0,0,1,0,1,2,0,7,0,1,1,0,0,1,0,0,0,0,2
E41000052,0,0,0,0,0,0,1,4,1,0,0,6,3,0,1,1,0,2,0,2,1,1,6,3,0,0,0,5,0,2,0,0
E41000053,0,0,0,0,0,0,1,0,1,0,1,1,9,0,0,0,0,0,3,0,1,0,4,0,0,0,0,0,0,0,0,0
E41000024,0,0,1,0,0,0,0,0,0,0,0,0,1,0,0,0,0,0,3,0,0,0,1,1,0,0,0,0,0,0,0,1
E41000025,0,0,0,0,0,0,0,1,1,0,0,0,0,0,0,0,0,0,3,0,0,0,2,2,0,0,1,4,0,5,0,5
E41000026,0,0,0,0,0,0,0,23,0,0,0,0,1,0,3,0,0,0,0,0,0,0,0,2,0,0,0,5,0,1,1,2
E41000027,0,0,0,0,0,0,0,1,0,0,0,1,0,0,0,0,0,0,0,0,0,0,0,2,0,0,0,1,0,0,0,0
E41000028,0,0,0,0,0,0,0,0,1,0,0,0,1,0,0,0,0,0,0,0,0,0,1,5,0,0,0,0,0,1,0,1
E41000029,0,0,0,0,0,0,0,0,0,0,0,0,0,0,0,0,0,0,0,0,0,0,1,0,0,0,0,0,0,0,0,0
E41000030,0,0,0,0,0,0,0,1,0,0,0,0,1,0,2,2,0,0,1,0,1,1,3,1,0,0,1,1,0,0,0,0
E41000079,0,0,0,0,0,0,0,0,2,0,0,0,1,0,0,0,0,0,0,0,0,0,1,0,0,0,0,0,0,0,0,0
E41000080,0,0,0,0,0,0,0,1,0,0,0,0,1,0,0,0,0,0,0,0,1,0,1,2,0,0,0,2,0,0,0,0
E41000081,0,0,0,0,0,0,0,0,0,0,0,0,2,0,0,0,0,0,0,0,0,0,0,0,0,0,0,0,0,0,0,0
E41000082,0,0,0,1,0,0,0,1,0,0,0,0,1,0,2,1,0,0,0,1,0,0,0,0,0,0,0,0,0,0,0,0
E41000083,0,0,0,0,0,0,0,0,0,0,0,0,0,0,0,0,0,0,0,0,0,0,1,0,0,0,0,1,0,0,0,0
E41000084,0,0,0,0,0,0,0,0,0,0,0,0,0,0,0,0,0,0,1,0,0,0,3,1,0,0,0,1,0,0,1,0
E41000085,0,0,0,0,0,0,0,0,0,0,0,1,0,0,2,0,0,0,0,0,0,0,0,0,0,0,0,0,0,0,0,0
E41000086,0,0,0,0,0,0,0,0,0,0,0,0,0,0,0,0,0,0,0,0,0,0,0,0,0,0,0,0,0,0,0,0
E41000087,0,0,0,0,0,0,0,0,0,0,0,0,0,0,0,0,0,0,0,0,0,0,0,0,0,0,0,0,0,0,0,0
E41000088,0,0,0,0,0,0,0,0,0,0,0,0,0,0,0,0,0,0,0,0,0,0,0,3,0,0,2,2,0,0,0,0
E41000089,0,0,0,0,0,0,0,0,0,0,0,0,0,0,0,0,0,0,2,0,0,0,0,0,1,0,0,0,0,0,0,0
E41000090,0,1,0,0,0,0,0,0,0,0,0,0,0,0,0,0,0,0,0,0,1,0,1,0,0,0,0,0,0,0,0,0
E41000091,0,1,0,0,0,0,0,1,0,0,0,0,0,0,0,0,0,0,0,0,1,0,0,0,0,0,0,0,0,0,0,0
E41000092,0,0,0,0,0,0,0,0,0,0,0,0,0,0,0,0,0,0,0,0,0,0,1,0,0,0,0,1,0,0,0,0
E41000110,0,0,0,0,0,0,0,0,0,0,0,0,0,0,0,0,0,0,0,0,0,2,1,0,0,0,0,0,0,0,0,2
E41000111,0,0,0,0,1,0,0,0,1,0,0,1,0,0,0,0,0,0,0,0,0,0,0,0,0,0,0,0,0,0,0,0
E41000112,0,0,0,0,0,0,0,0,1,0,0,1,0,0,0,1,0,0,0,1,0,0,0,1,0,0,0,1,0,0,0,0
E41000113,0,0,0,0,1,0,0,0,0,0,0,1,0,0,0,0,0,0,0,0,1,0,1,0,0,0,0,0,0,0,0,1
E41000114,0,0,0,0,0,0,0,0,0,0,0,0,1,0,0,0,0,0,0,0,2,0,1,1,0,0,0,0,0,0,0,0
E41000115,0,0,0,0,0,0,0,0,0,0,0,0,0,0,0,0,0,0,0,0,0,0,0,1,0,0,0,0,0,0,0,1
E41000208,0,0,0,0,0,0,0,0,0,0,0,0,1,0,0,0,0,0,0,0,0,0,0,4,1,0,0,2,0,1,0,0
E41000209,0,0,0,0,0,0,0,0,1,0,0,3,1,0,1,0,0,0,4,0,0,0,0,2,0,0,1,0,0,0,0,1
E41000210,0,0,0,0,0,0,4,1,0,0,0,0,0,0,0,0,0,1,0,0,0,0,2,1,0,0,0,2,0,0,0,0
E41000211,0,0,0,0,0,0,0,3,4,0,1,0,0,0,0,0,0,0,0,0,0,0,0,2,0,0,0,0,0,0,0,0
E41000212,0,0,0,0,0,0,0,0,0,0,0,0,0,0,0,0,0,0,0,0,0,0,0,0,0,0,0,0,0,0,0,0
W40000001,0,0,0,0,0,0,0,0,0,0,0,1,1,0,0,0,0,0,0,0,1,1,1,0,0,0,2,1,0,0,0,0
W40000002,0,0,0,0,0,0,0,0,1,0,0,1,1,0,0,0,0,0,0,0,0,0,0,0,0,0,0,0,0,0,0,2
W40000003,0,0,0,0,0,0,0,0,0,0,0,0,0,0,0,0,0,0,1,0,0,0,0,3,0,0,1,2,0,0,0,1
W40000004,0,0,0,0,0,0,0,0,0,0,0,1,0,0,0,0,0,0,0,0,1,0,0,0,0,0,0,0,0,0,0,0
W40000005,0,0,0,0,0,0,0,1,0,0,0,0,2,0,0,3,0,1,0,0,0,0,0,6,0,0,0,0,1,2,0,0
W40000006,0,0,0,0,0,0,0,0,0,0,0,1,0,0,0,0,0,0,1,0,0,0,0,0,0,0,0,0,0,0,0,8
W40000007,0,0,0,0,0,0,0,0,0,0,0,0,0,0,0,0,0,0,0,0,0,3,0,0,0,0,0,0,0,0,0,0
W40000008,0,0,0,0,0,0,1,0,0,0,0,1,8,0,1,0,0,2,0,0,0,0,2,1,0,0,0,0,0,0,0,0
W40000009,0,0,0,0,0,2,0,0,5,0,0,0,11,0,0,1,0,0,1,0,0,0,0,0,0,0,0,5,0,1,0,0
W40000010,0,0,1,0,0,1,0,1,0,0,0,0,3,0,0,0,0,0,1,0,1,0,1,2,0,1,0,0,0,1,0,1
W40000011,0,0,0,0,0,0,0,1,0,0,0,0,0,0,0,0,0,0,0,0,0,1,3,2,0,0,0,0,0,1,0,0
W40000012,0,0,0,0,0,0,1,1,3,0,0,0,0,0,1,0,0,0,1,3,1,0,0,0,0,0,3,1,0,0,0,0
W40000013,0,2,0,0,0,0,0,0,0,0,0,1,0,0,1,0,0,0,2,0,0,0,0,0,0,0,0,16,0,0,0,0
W40000014,0,1,0,0,0,0,1,0,1,0,0,1,1,0,1,0,0,0,1,0,0,0,0,3,1,0,1,4,0,1,0,4
W40000015,0,10,0,0,0,2,0,0,0,0,0,1,6,0,0,0,0,0,0,0,1,0,1,0,0,0,0,0,0,2,0,1
W40000016,0,1,1,0,0,0,1,2,0,0,1,0,3,0,0,0,0,1,0,1,0,0,1,2,0,0,2,0,0,0,0,4
W40000017,0,1,0,0,0,0,0,0,0,0,0,0,0,0,0,0,0,0,0,0,0,0,0,1,0,0,0,0,0,2,0,1
W40000018,0,0,0,0,0,0,0,0,0,0,0,0,2,0,1,0,0,0,0,0,0,0,0,0,0,0,0,0,0,1,0,0
W40000019,0,1,0,0,0,0,0,0,0,0,0,0,2,0,0,0,0,0,0,0,1,0,0,1,0,0,0,0,0,1,0,1
W40000020,0,0,0,0,0,0,0,0,0,0,0,0,0,0,0,0,0,0,0,0,0,0,0,1,0,0,0,0,0,0,0,0
W40000021,0,0,0,0,0,0,0,2,0,0,0,1,0,0,0,0,0,0,0,0,0,0,0,4,0,0,0,1,0,0,0,0
W40000022,0,0,0,0,0,0,1,0,0,0,0,1,1,0,0,0,0,0,0,0,0,0,0,2,0,1,0,0,0,0,0,0
